1 1 1 1 1 1 1 1 1 1 1 1 1 1 1 1 1 1 1 1 1
1 8 0 0 0 0 0 0 0 0 1 0 0 0 0 0 0 0 0 8 1
1 0 1 1 1 0 1 1 1 0 1 0 1 1 1 0 1 1 1 0 1
1 0 1 1 1 0 1 1 1 0 1 0 1 1 1 0 1 1 1 0 1
1 0 0 0 0 0 0 0 0 0 0 0 0 0 0 0 0 0 0 0 1
1 0 1 1 1 0 1 0 1 1 1 1 1 0 1 0 1 1 1 0 1
1 0 0 0 0 0 1 0 1 1 1 1 1 0 1 0 0 0 0 0 1
1 1 1 1 1 0 1 0 0 0 1 0 0 0 1 0 1 1 1 1 1
2 2 2 2 1 0 1 1 1 0 1 0 1 1 1 0 1 2 2 2 2
2 2 2 2 1 0 1 0 0 0 0 0 0 0 1 0 1 2 2 2 2
2 2 2 2 1 0 1 0 1 1 10 1 1 0 1 0 1 2 2 2 2
2 2 2 2 1 0 0 0 1 3 7 6 1 0 0 0 1 2 2 2 2
2 2 2 2 1 0 1 0 1 4 7 5 1 0 1 0 1 2 2 2 2
2 2 2 2 1 0 1 0 1 1 1 1 1 0 1 0 1 2 2 2 2
2 2 2 2 1 0 1 0 0 0 9 0 0 0 1 0 1 2 2 2 2
1 1 1 1 1 0 1 0 1 1 1 1 1 0 1 0 1 1 1 1 1
1 0 0 0 0 0 0 0 0 0 1 0 0 0 0 0 0 0 0 0 1
1 0 1 1 1 0 1 1 1 0 1 0 1 1 1 0 1 1 1 0 1
1 0 0 0 1 0 0 0 0 0 0 0 0 0 0 0 1 0 0 0 1
1 1 1 0 1 0 1 0 1 1 1 1 1 0 1 0 1 0 1 1 1
1 0 0 0 0 0 1 0 0 0 1 0 0 0 1 0 0 0 0 0 1
1 0 1 1 1 1 1 1 1 0 1 0 1 1 1 1 1 1 1 0 1
1 8 0 0 0 0 0 0 0 0 0 0 0 0 0 0 0 0 0 8 1
1 1 1 1 1 1 1 1 1 1 1 1 1 1 1 1 1 1 1 1 1
2 2 2 2 2 2 2 2 2 2 2 2 2 2 2 2 2 2 2 2 2
