1 1 1 1 1 1 1 1 1 1 1 1 1 1 1 1 1 1 1 1 1 1 1 1 1 1 1 1 1 1
1 8 0 0 0 0 0 0 0 0 0 0 0 0 0 0 0 0 0 0 0 0 0 0 0 0 0 8 1 1
1 0 20 20 20 0 20 20 20 0 20 20 20 0 20 20 20 0 20 20 20 0 20 0 1 0 20 0 1 1
1 0 20 7 7 0 20 0 0 0 20 7 7 0 20 7 20 0 20 7 20 0 20 0 1 0 20 0 1 1
1 0 20 20 20 0 20 0 1 0 20 20 20 0 20 20 20 0 20 7 20 0 20 0 1 0 20 0 1 1
1 0 20 0 0 0 20 0 1 0 20 7 7 0 20 0 9 0 20 7 20 0 20 0 0 0 0 0 1 1
1 0 20 0 1 0 20 0 1 0 20 20 20 0 20 0 1 0 20 20 20 0 20 20 20 0 20 0 1 1
1 0 0 0 1 0 0 0 0 0 0 0 0 0 0 0 1 0 0 0 0 0 0 0 0 0 0 0 0 1
1 0 1 1 1 1 1 1 1 1 1 1 1 1 1 1 1 1 1 1 1 1 1 1 1 1 1 1 0 1
1 0 0 0 0 0 0 0 0 0 0 0 0 0 0 0 1 0 0 0 0 0 0 0 0 0 0 0 0 1
1 0 20 7 20 0 20 20 20 0 20 20 20 0 20 0 1 0 20 0 0 20 0 20 7 20 0 1 0 1
1 0 20 7 20 0 20 0 0 0 20 7 20 0 20 0 0 0 20 0 0 20 0 20 20 7 0 1 0 1
1 0 0 20 0 0 20 0 1 0 20 20 20 0 20 20 20 0 20 0 20 20 0 20 7 20 0 1 0 1
1 0 0 0 0 0 0 0 0 0 0 0 0 0 0 0 0 0 0 0 0 0 0 0 0 0 0 0 0 1
1 0 20 20 20 0 20 20 20 0 20 7 7 20 0 20 0 0 20 20 20 0 20 20 20 0 20 20 0 1
1 0 20 7 7 0 0 20 0 0 20 7 20 7 0 20 0 0 20 7 20 0 20 7 20 0 20 7 0 1
1 0 20 20 20 0 0 20 0 0 20 20 7 7 0 20 0 0 20 20 20 0 20 20 20 0 20 20 0 1
1 0 7 7 20 0 0 20 0 0 20 7 20 7 0 20 0 0 20 7 20 0 20 7 20 0 7 20 0 1
1 0 20 20 20 0 0 20 0 0 20 7 7 20 0 20 20 0 20 7 20 0 20 7 20 0 20 20 0 1
1 8 0 0 0 0 0 0 0 0 0 0 0 0 0 0 0 0 0 0 0 0 0 0 0 0 0 0 8 1
1 1 1 1 1 1 1 1 1 1 1 1 1 1 1 10 1 1 1 1 1 1 1 1 1 1 1 1 1 1
2 2 2 2 2 2 2 2 2 2 2 2 2 1 3 7 6 1 2 2 2 2 2 2 2 2 2 2 2 2
2 2 2 2 2 2 2 2 2 2 2 2 2 1 4 7 5 1 2 2 2 2 2 2 2 2 2 2 2 2
2 2 2 2 2 2 2 2 2 2 2 2 2 1 1 1 1 1 2 2 2 2 2 2 2 2 2 2 2 2
2 2 2 2 2 2 2 2 2 2 2 2 2 2 2 2 2 2 2 2 2 2 2 2 2 2 2 2 2 2
